#######################
#                   O #
#          X          #
#                  ####
#     ######    X     #
#    X   O            #
#         #           #
#        O   X ###    #
######         #      #
#   X      P  #  O    #
#       #             #
#      O#       #     #
#       #    X   #    #
#  O              #   #
#######################
